{
  "levels": [
    {
      "id": 1,
      "name": "Tutorial - Straight Path",
      "size": [15, 12],
      "hazards": 2,
      "powerups": 1,
      "data": [
        [1,1,1,1,1,1,1,1,1,1,1,1,1,1,1],
        [1,0,0,0,0,0,0,0,0,0,0,0,0,0,1],
        [1,0,1,1,1,1,0,0,0,1,1,1,1,0,1],
        [1,0,1,0,0,0,0,2,0,0,0,0,1,0,1],
        [1,0,1,0,0,0,0,0,0,0,0,0,1,0,1],
        [1,3,0,0,0,0,0,0,0,0,0,0,0,0,1],
        [1,0,1,0,0,0,0,0,0,0,0,0,1,0,1],
        [1,0,1,0,0,0,0,2,0,0,0,0,1,0,1],
        [1,0,1,1,1,1,0,0,0,1,1,1,1,0,1],
        [1,0,0,0,0,0,0,0,0,0,0,0,0,4,1],
        [1,0,0,0,0,0,0,0,0,0,0,0,0,0,1],
        [1,1,1,1,1,1,1,1,1,1,1,1,1,1,1]
      ]
    },
    {
      "id": 2,
      "name": "Tutorial - Corner Turn",
      "size": [15, 12],
      "hazards": 3,
      "powerups": 1,
      "data": [
        [1,1,1,1,1,1,1,1,1,1,1,1,1,1,1],
        [1,3,0,0,0,0,0,0,0,0,0,0,0,0,1],
        [1,0,1,1,1,1,1,1,1,1,1,1,1,0,1],
        [1,0,1,0,0,0,0,2,0,0,0,0,0,0,1],
        [1,0,1,0,1,1,1,1,1,1,1,1,1,0,1],
        [1,0,0,0,1,0,0,0,0,2,0,0,1,0,1],
        [1,0,1,0,1,0,1,1,1,1,1,0,1,0,1],
        [1,0,1,0,0,0,1,0,0,2,1,0,1,0,1],
        [1,0,1,1,1,1,1,0,0,0,1,0,0,0,1],
        [1,0,0,0,0,0,0,0,1,1,1,0,1,0,1],
        [1,0,0,0,0,0,0,0,0,0,0,0,1,4,1],
        [1,1,1,1,1,1,1,1,1,1,1,1,1,1,1]
      ]
    },
    {
      "id": 3,
      "name": "Tutorial - Zigzag",
      "size": [15, 12],
      "hazards": 4,
      "powerups": 2,
      "data": [
        [1,1,1,1,1,1,1,1,1,1,1,1,1,1,1],
        [1,3,0,0,0,0,0,0,1,0,0,0,0,0,1],
        [1,1,1,1,1,1,0,0,1,0,1,1,1,0,1],
        [1,0,0,0,0,0,0,2,1,0,0,0,1,0,1],
        [1,0,1,1,1,1,1,1,1,0,1,0,1,0,1],
        [1,0,0,0,2,0,0,0,0,0,1,0,0,0,1],
        [1,1,1,0,1,1,1,1,1,1,1,0,1,1,1],
        [1,0,0,0,0,0,2,0,0,0,0,0,1,0,1],
        [1,0,1,1,1,1,1,1,1,0,1,1,1,0,1],
        [1,0,1,0,0,0,0,2,0,0,0,0,0,0,1],
        [1,0,0,0,1,1,1,0,1,1,1,1,1,4,1],
        [1,1,1,1,1,1,1,1,1,1,1,1,1,1,1]
      ]
    },
    {
      "id": 4,
      "name": "Challenge - Maze",
      "size": [15, 12],
      "hazards": 5,
      "powerups": 2,
      "data": [
        [1,1,1,1,1,1,1,1,1,1,1,1,1,1,1],
        [1,3,0,0,1,0,0,0,0,0,1,0,0,4,1],
        [1,1,1,0,1,0,1,1,1,0,1,0,1,1,1],
        [1,0,0,0,0,0,1,2,1,0,0,0,0,0,1],
        [1,0,1,1,1,1,1,0,1,1,1,1,1,0,1],
        [1,0,0,0,2,0,0,0,0,0,2,0,0,0,1],
        [1,0,1,1,1,1,1,0,1,0,1,1,1,0,1],
        [1,0,1,0,0,0,0,0,1,0,0,0,1,0,1],
        [1,0,1,0,1,1,1,2,1,1,1,0,1,0,1],
        [1,0,0,0,1,0,0,0,0,0,1,0,0,0,1],
        [1,0,1,1,1,0,1,1,1,0,1,1,1,2,1],
        [1,1,1,1,1,1,1,1,1,1,1,1,1,1,1]
      ]
    },
    {
      "id": 5,
      "name": "Final - Gauntlet",
      "size": [15, 12],
      "hazards": 6,
      "powerups": 2,
      "data": [
        [1,1,1,1,1,1,1,1,1,1,1,1,1,1,1],
        [1,3,0,0,0,2,0,0,0,2,0,0,0,0,1],
        [1,1,1,1,1,1,1,0,1,1,1,1,1,0,1],
        [1,0,0,0,0,0,0,0,0,0,0,0,0,0,1],
        [1,0,1,1,1,0,1,1,1,1,1,0,1,1,1],
        [1,0,0,2,1,0,0,0,2,0,0,0,1,0,1],
        [1,1,1,0,1,1,1,0,1,0,1,1,1,0,1],
        [1,0,0,0,0,0,1,0,1,0,0,0,0,0,1],
        [1,0,1,1,1,0,1,2,1,0,1,1,1,1,1],
        [1,0,0,0,1,0,0,0,0,0,1,0,0,0,1],
        [1,0,1,0,1,1,1,1,1,1,1,0,1,4,1],
        [1,1,1,1,1,1,1,1,1,1,1,1,1,1,1]
      ]
    }
  ]
}
